Start: 1 4
End: 9 9
Map Begin: 10
1 1 1 0 1 0 1 0 1 0 
0 1 0 0 1 0 1 0 1 0 
0 1 0 1 1 0 1 0 1 1 
0 1 0 1 0 0 1 0 0 1 
0 1 0 0 0 1 1 0 0 0 
0 1 0 1 0 0 1 0 1 1 
0 0 0 0 1 0 1 0 1 0 
1 1 1 0 0 1 1 0 1 1 
1 0 1 0 0 1 1 0 0 1 
1 1 1 1 0 0 0 0 1 1 
Map End:
