Start: 1 4
End: 7 6
Map Begin: 10
1 1 1 0 1 0 0 0 1 0
0 1 0 0 1 0 1 0 1 0
0 1 0 1 1 0 1 0 1 1
0 1 0 1 0 0 1 0 0 1
0 1 0 0 0 1 1 1 0 0
0 1 0 1 1 1 0 1 1 1
0 0 0 0 1 0 0 0 1 0
1 1 1 0 1 1 1 0 1 1
1 0 1 0 0 1 1 0 0 1
1 1 1 1 0 0 0 0 1 1
Map End: