Name: Baba ORiley
Start: 7 10
End: 22 25
Map Begin: 25
1 1 1 0 1 0 0 0 1 0 1 1 1 1 1 0 0 0 1 1 1 0 0 0 1
0 1 0 0 1 0 1 0 1 0 0 1 1 0 0 0 1 0 1 1 1 0 1 0 0
0 1 0 1 1 0 1 0 1 1 0 1 1 0 1 1 1 0 1 0 0 0 1 1 0
0 1 0 1 0 0 1 0 0 1 0 1 0 0 0 1 1 0 0 0 1 1 1 1 0
0 1 0 0 0 1 1 1 0 0 0 1 0 1 0 1 0 0 1 1 1 0 0 0 0
0 1 0 1 1 1 0 1 1 1 0 1 0 1 0 1 1 1 1 0 1 0 1 1 1
0 0 0 0 1 0 0 0 1 0 0 1 0 1 0 1 0 0 0 0 0 0 1 0 0
1 1 1 0 1 1 1 0 1 1 1 1 0 1 0 1 0 1 1 1 1 1 1 1 1
1 0 1 0 0 1 1 0 0 1 0 0 0 1 0 1 0 1 1 0 0 0 0 1 1
1 1 1 1 0 1 1 0 1 1 0 1 1 1 0 1 0 0 0 0 1 1 0 0 0
0 0 0 1 0 1 0 0 1 0 0 1 0 0 0 1 0 1 1 1 1 1 1 1 0
0 1 0 0 0 1 0 1 1 0 1 1 1 1 1 1 0 1 0 1 0 0 0 1 0
0 1 1 1 1 1 0 1 0 0 1 0 0 0 0 0 0 1 0 1 0 1 0 0 0
0 0 0 0 0 0 0 1 0 1 1 0 1 1 1 1 1 1 0 1 0 1 1 1 1
1 1 1 1 1 1 0 1 0 1 0 0 1 1 0 0 0 0 0 1 0 0 0 0 1
1 1 0 1 0 0 0 0 0 1 1 0 0 1 0 1 1 1 1 1 0 1 1 0 0
1 1 0 1 0 1 1 1 1 1 1 1 0 1 0 1 0 0 0 0 0 1 1 1 0
0 0 0 1 0 0 0 1 0 0 0 1 0 1 0 1 0 1 1 1 1 1 0 0 0
0 1 0 1 1 1 0 1 1 1 0 1 0 1 0 1 0 1 1 1 1 1 1 1 1
0 1 0 0 0 0 0 1 1 1 0 1 0 0 0 1 0 1 0 0 0 0 0 0 0
0 1 1 1 1 1 1 1 0 0 0 1 1 1 1 1 0 1 0 1 1 1 1 1 0
0 0 0 0 0 0 0 0 0 1 1 1 1 1 1 0 0 1 0 0 0 0 1 1 0
1 1 1 1 1 1 1 1 1 1 0 0 0 0 0 0 1 1 0 0 1 0 1 1 0  junk over here
0 0 0 1 1 0 0 0 0 0 0 1 0 1 1 1 1 0 0 1 1 0 1 1 0
1 1 0 0 0 0 1 1 1 1 1 1 0 0 0 0 0 0 1 1 0 0 0 0 0
Map End:

Nonsense is the spice of life.
Can I really just put anything down here?
Apparently so :-)
As long as I do not use any keywords  . . .
